11111111111111111111111111
1C01000000000C101C000000C1
10C00110110010001011111001
1P0011C0C1C0110C001CCC00E1
11111111111111111111111111
