111111111111111111111111111111111111111111111111111111111111
1E0000000000000C00000C000000000000000000000000000C00000C0001
101001010010000010100100000001010000100101001000001010010001
101001001010100000100100000001010000100100101010000010010001
1P0000000C00C0000000000000000000C0000000000C00C0000000000001
111111111111111111111111111111111111111111111111111111111111