11111111111111111111111111111111111111111111111111111111111
1E0000000000000C00000C000000000000000000000000000C00000C001
10100101001000001010010000000101000010010100100000101001001
10100100101010000010010000000101000010010010101000001001001
1P0000000C00C0000000000000000000C0000000000C00C000000000001
100000000C00C0000000000000000000C0000000000C00C000000000001
100000000C00C0000000000000000000C0000000000C00C000000000001
100000000C00C0000000000000000000C0000000000C00C000000000001
100000000C00C0000000000000000000C0000000000C00C000000000001
100000000C00C0000000000000000000C0000000000C00C000000000001
100000000C00C0000000000000000000C0000000000C00C000000000001
100000000C00C0000000000000000000C0000000000C00C000000000001
100000000C00C0000000000000000000C0000000000C00C000000000001
100000000C00C0000000000000000000C0000000000C00C000000000001
100000000C00C0000000000000000000C0000000000C00C000000000001
100000000C00C0000000000000000000C0000000000C00C000000000001
100000000C00C0000000000000000000C0000000000C00C000000000001
100000000C00C0000000000000000000C0000000000C00C000000000001
100000000C00C0000000000000000000C0000000000C00C000000000001
100000000C00C0000000000000000000C0000000000C00C000000000001
100000000C00C0000000000000000000C0000000000C00C000000000001
100000000C00C0000000000000000000C0000000000C00C000000000001
100000000C00C0000000000000000000C0000000000C00C000000000001
100000000C00C0000000000000000000C0000000000C00C000000000001
100000000C00C0000000000000000000C0000000000C00C000000000001
100000000C00C0000000000000000000C0000000000C00C000000000001
100000000C00C0000000000000000000C0000000000C00C000000000001
100000000C00C0000000000000000000C0000000000C00C000000000001
100000000C00C0000000000000000000C0000000000C00C000000000001
100000000C00C0000000000000000000C0000000000C00C000000000001
100000000C00C0000000000000000000C0000000000C00C000000000001
11111111111111111111111111111111111111111111111111111111111